0000000000000000000
0000000000000000000
0000000000000000000
0002220000000222000
0002420000000242000
0002220000000222000
0000000000000000000
0000000011100000000
0000000011100000000
0000000011100000000
0000000000000000000
0003300000000033000
0003300000000033000
0000333333333330000
0000000000000000000
0000000000000000000
0000000000000000000
0000000000000000000
0000000000000000000