0000000000000000000
0000000000000000000
0111111111111111110
0001111111111111000
0000011111111100000
0000000011110000000
0000000001100000000
0000000000000000000
0000000000000000000
0000000000000000000
0000000000000000000
0000000000000000000
0111111111111111110
0000000000000000000
0000000000000000000
0000000000000000000
0000000000000000000
0000000000000000000
0000000011000000000