0444444444444444440
0300000000000000000
0000000000000000000
0111111111111111110
0000000000000000000
0000000000000000220
0000000000000003300
0000000000000000000
0000000000000000000
0000000000000000000
0000000000000000000
0000000000000000000
0000000000000000000
0000000000000000000
0222222222222222220
0000000000000000000
0000000000000000000
0000000000000000000
0000000000000000000